0,0,0,A,A,A,0,0,0,0
0,0,0,0,0,0,0,0,C,0
0,0,0,0,0,0,0,0,C,0
0,0,0,0,0,0,0,0,C,0
0,0,0,B,0,0,0,0,C,0
0,0,0,B,0,0,0,0,0,0
0,0,0,0,0,0,0,0,0,0
0,0,0,0,0,0,D,D,D,0
E,E,E,E,E,0,0,0,0,0
0,0,0,0,0,0,0,0,0,0